"filename", "language", "C++", "cmake", "comment", "blank", "total"
"e:\MyWorkSpace\vscode-structdata\src\CMakeLists.txt", "cmake", 0, 14, 15, 10, 39
"e:\MyWorkSpace\vscode-structdata\src\Deque\CMakeLists.txt", "cmake", 0, 3, 1, 1, 5
"e:\MyWorkSpace\vscode-structdata\src\Deque\Deque.hpp", "C++", 132, 0, 59, 21, 212
"e:\MyWorkSpace\vscode-structdata\src\Linkedlist\CMakeLists.txt", "cmake", 0, 3, 4, 2, 9
"e:\MyWorkSpace\vscode-structdata\src\Linkedlist\DoublyLinkedList.hpp", "C++", 295, 0, 154, 45, 494
"e:\MyWorkSpace\vscode-structdata\src\Linkedlist\LinkedList.hpp", "C++", 290, 0, 57, 46, 393
"e:\MyWorkSpace\vscode-structdata\src\Seqlist\CMakeLists.txt", "cmake", 0, 3, 2, 2, 7
"e:\MyWorkSpace\vscode-structdata\src\Seqlist\SeqList.hpp", "C++", 173, 0, 140, 29, 342
"e:\MyWorkSpace\vscode-structdata\src\SortAlgo\CMakeLists.txt", "cmake", 0, 0, 0, 1, 1
"e:\MyWorkSpace\vscode-structdata\src\SortAlgo\Sort.hpp", "C++", 64, 0, 0, 35, 99
"e:\MyWorkSpace\vscode-structdata\src\SortAlgo\test.hpp", "C++", 5, 0, 0, 14, 19
"e:\MyWorkSpace\vscode-structdata\src\Stack\CMakeLists.txt", "cmake", 0, 3, 1, 3, 7
"e:\MyWorkSpace\vscode-structdata\src\Stack\Hanoi.hpp", "C++", 18, 0, 0, 7, 25
"e:\MyWorkSpace\vscode-structdata\src\Stack\Stack.hpp", "C++", 245, 0, 14, 59, 318
"e:\MyWorkSpace\vscode-structdata\src\String\CMakeLists.txt", "cmake", 0, 3, 1, 1, 5
"e:\MyWorkSpace\vscode-structdata\src\String\String.hpp", "C++", 131, 0, 71, 25, 227
"e:\MyWorkSpace\vscode-structdata\src\Tree\Binary_Tree.hpp", "C++", 249, 0, 130, 44, 423
"e:\MyWorkSpace\vscode-structdata\src\Tree\CMakeLists.txt", "cmake", 0, 3, 1, 1, 5
"e:\MyWorkSpace\vscode-structdata\src\main.cpp", "C++", 44, 0, 56, 24, 124
"Total", "-", 1646, 32, 706, 370, 2754